11111111111111111111
1E0000000000000000C1
10000000000000111111
10000000000000000001
1110000000000C011111
1C100000000000000001
10100000000000000001
10100000000000000001
10100000000000000001
10100000000000000001
10100000000000000001
10111111011111101001
1000000001000C1C10C1
11111011110101111111
1C0000000001000000P1
11111111111111111111
