1111111111
1E000000C1
1000111111
1000000001
100C011111
10000000P1
1111111111
