1111111111111111
1P00000000010011
1111111111111001
1111111111111101
1100000000000001
1001111111111111
1011111111111111
1000C00000000001
1111111111111101
1111111111111001
1E00000000000011
1111111111111111