1111111111
1E00000001
100000X001
100C000001
1000000101
10000001P1
1111111111
