1111111111
1E00000001
1000000001
100C000001
1000000000
10000000P1
1111111111
